30 29
b b b b b b b b b b b b b b b b b b b b b b b b b b b b b 
b o o o o o o o o o o o o b b b o o o o o o o o o o o o b
b o b b b b o b b b b b o b b b o b b b b b o b b b b o b 
b p b b b b o b b b b b o b b b o b b b b b o b b b b p b
b o o o o o s o o o o o o o o o o o o o o o s o o o o o b
b o b b b b o b b o b b b b b b b b b o b b o b b b b o b
b o b b b b o b b o b b b b b b b b b o b b o b b b b o b
b o o o o o o b b o o o o b b b o o o o b b o o o o o o b
b b b b b b o b b b b b e b b b e b b b b b o b b b b b b
d d d d d b o b b b b b e b b b e b b b b b o b b b b b b
d d d d d b o b b e e e e e e e e e e e b b o b d d d d d
d d d d d b o b b e b b b g g g b b b e b b o b d d d d d
b b b b b b o b b e b e e e e e e e b e b b o b b b b b b
e e e e e e o e e j b e e e e e e e b j e e o e e e e e e
b b b b b b o b b e b e e e e e e e b e b b o b b b b b b 
d d d d d b o b b e b b b b b b b b b e b b o b d d d d d
d d d d d b o b b e e e e e e e e e e e b b o b d d d d d
d d d d d b o b b e b b b b b b b b b e b b o b d d d d d
b b b b b b o b b e b b b b b b b b b e b b o b b b b b b
b o o o o o s o o o o o o b b b o o o o o o s o o o o o b
b o b b b b o b b b b b o b b b o b b b b b o b b b b o b
b o b b b b o b b b b b o b b b o b b b b b o b b b b o b
b p o o b b o o o o o o o e e e o o o o o o o b b o o p b
b b b o b b o b b o b b b b b b b b b o b b o b b o b b b
b b b o b b o b b o b b b b b b b b b o b b o b b o b b b
b o o o o o o b b o o o o b b b o o o o b b o o o o o o b
b o b b b b b b b b b b o b b b o b b b b b b b b b b o b
b o b b b b b b b b b b o b b b o b b b b b b b b b b o b
b o o o o o o o o o o o o o o o o o o o o o o o o o o o b
b b b b b b b b b b b b b b b b b b b b b b b b b b b b b